0 0 0 0 0 0 0 0 R 0 0 0 0 0 R R 0 0 0 0 0 0 0 0 0 0 0 R R R 0
R 0 0 0 R 0 T 0 R 0 0 R 0 0 0 0 0 0 0 0 R 0 0 0 0 0 R 0 0 0 0
0 0 0 0 0 0 0 0 0 0 0 0 0 0 0 0 0 0 0 0 0 0 0 0 0 0 0 0 0 0 0
R R 0 0 0 R R R R R R R R R R 0 R R 0 R R R 0 0 0 0 0 0 0 0 0
0 0 0 0 R 0 0 0 Mb1 0 0 0 R 0 0 R 0 0 0 0 R R 0 R R 0 0 0 0 0 0
0 0 0 0 0 0 0 0 R 0 0 0 0 0 R R 0 0 0 0 0 0 0 0 0 0 0 R R R 0
R 0 0 0 R 0 0 0 R 0 0 R 0 0 0 0 0 Mb2 0 0 R 0 0 HH 0 0 R 0 0 0 0
0 0 0 0 0 0 0 0 0 0 0 Mb3 0 0 0 0 0 R 0 0 0 0 0 0 0 0 0 0 0 P 0
R R 0 0 0 R R R R R R R R R 0 0 R R R R R R 0 0 0 0 0 0 0 0 0
0 0 0 0 R 0 B 0 0 0 0 0 R 0 0 0 0 0 0 0 R R R R R 0 0 0 0 0 0
0 0 0 0 0 0 0 0 R 0 0 0 0 0 R R 0 0 0 0 0 0 0 0 0 0 0 R R R 0
R 0 0 0 R 0 0 0 R 0 0 R 0 0 0 0 0 0 0 0 R 0 0 0 0 0 R 0 0 0 0
0 0 0 0 0 0 0 0 0 0 0 0 0 0 0 0 0 0 0 0 0 R 0 0 0 0 0 0 0 0 0
R R 0 0 0 R R SH R R 0 0 0 0 0 R R 0 0 R R R 0 0 0 0 0 0 0 0 0
0 0 0 0 R 0 0 0 R 0 0 0 R 0 0 R 0 0 0 0 R R R R R 0 0 0 0 0 0
0 0 0 0 0 0 B 0 R 0 0 0 0 0 R R 0 0 0 0 0 0 0 0 0 0 0 R R R 0
R 0 0 0 R 0 0 0 R 0 0 R SH 0 R 0 0 0 0 0 R 0 0 0 R R R R R R 0
0 0 0 0 0 0 0 T 0 0 0 0 Mb4 0 0 0 0 0 0 0 0 0 0 0 R 0 0 0 0 0 0
R R 0 0 0 R 0 0 R R 0 0 R R R R 0 0 0 0 0 0 0 Mb0 R 0 0 e 0 0 0
R R R R R R R R R R R R R R R R R R R R R R R R 0 0 0 H s 0 0